1984 – George Orwell
31 Canções – Nick Hornby
A Abadia de Northanger – Jane Austen
A Arte da Ficção – Henry James
A Arte da Guerra – Sun Tzu
A Bolt from the Blue and Other Essays – Mary McCarthylivros
A Bíblia Sagrada
A Cabana do Pai Tomás – Harriet Beecher Stowe
A Caldeira do Diabo – Grace Metalious
A Casa dos Espíritos – Isabel Allende
A Comédia dos Erros – William Shakespeare
A Célebre Rã Saltadora do Condado de Cavaleras – Mark Twain
A Divina Comédia – Dante Alighieri
A Escolha de Sofia – William Styron
A Feira das Vaidades – William Makepeace Thackeray
A Heartbreaking Work of Staggering Genius – Dave Eggers
A História do Declínio e Queda do Império Romano – Edward Gibbon
A Ilíada – Homero
A Letra Escarlate – Nathaniel Hawthorne
A Maratona da Morte – William Goldman
A Metamorfose – Franz Kafka
A Monetary History of the United States – Milton Friedman
A Month Of Sundays: Searching For The Spirit And My Sister – Julie Mars
A Morte de Um Caixeiro-Viajante – Arthur Miller
A Mulher do Viajante no Tempo – Audrey Niffenegger
A Nascente – Ayn Rand
A Noite do Oráculo – Paul Auster
A Noite – Elie Wiesel
A Pequena Dorrit* – Charles Dickens
A Pequena Vendedora de Fósforos – Hans Christian Andersen
A Primeira Noite de um Homem – Charles Webb
A Quiet Storm – Rachel Howzell Hall
A Redoma de Vidro – Sylvia Plath
A Sangue Frio – Truman Capote
A Selva – Upton Sinclair
A Sociedade do Anel – J. R. R. Tolkien
A Sombra do Vento – Carlos Ruiz Zafón
A Teia de Charlotte – E. B. White
A Vida Secreta das Abelhas – Sue Monk Kidd
A Vida de Pi – Yann Martel
A Vingança de Bette – Honoré de Balzac
A Última Grande Lição: o sentido da vida – Mitch Albom
Admirável Mundo Novo – Aldous Huxley
Alice no País das Maravilhas – Lewis Carroll
Almas Mortas – Nikolai Gogol
Alta Fidelidade – Nick Hornby
Amada – Toni Morrison
Anna Karenina – Leon Tolstoy
Ardil 22 – Joseph Heller
As Alegres Matronas de Windsor – William Shakespeare
As Aventuras de Huckleberry Finn – Mark Twain
As Bruxas de Salém – Arthur Miller
As Cinco Pessoas que Você Encontra no Céu – Mitch Albom
As Cinzas de Ângela – Frank McCourt
As Incríveis Aventuras de Kavalier & Clay – Michael Chabon
As Neves do Kilimanjaro e Outros Contos – Ernest Hemingway
As Vantagens de ser Invisível – Stephen Chbosky
As Vinhas da Ira – John Steinbeck
As Virgens Suicidas – Jeffrey Eugenides
Autobiography of a Face – Lucy Grealy
Babe – Dick King-Smith
Backlash: The Undeclared War Against American Women – Susan Faludi
Bagavadguitá
Balzac e a Costureirinha Chinesa – Dai Sijie
Bambi – Felix Salten
Bel Canto – Ann Patchett
Beowulf: A New Verse Translation – Seamus Heaney
Bitch in Praise of Difficult Women – Elizabeth Wurtzel
Bondade – Carol Shields
Branca de Neve e Rosa Vermelha – Os Irmãos Grimm
Brigadoon – Alan Jay Lerner
Cachinhos Dourados e os Três Ursos – Alvin Granowsky
Carrie, A Estranha – Stephen King
Cartas a um Jovem Poeta – Rainer Maria Rilkelivros06
Casa de Areia e Névoa – Andre Dubus III
Cem Anos de Solidão – Gabriel Garcia Marquez
Christine – Stephen King
Como Respirar Debaixo D’Água – Julie Orringerlivros05
Como o Grinch Roubou o Natal – Dr. Seuss
Complete Novels – Dawn Powell
Complete Stories – Dorothy Parker
Conduzindo Miss Daisy – Alfred Uhry
Confissões de uma Groupie: I’m With the Band – Pamela des Barres
Cozinha Confidencial: Uma Aventura nas Entranhas da Culinária* – Anthony Bourdain
Crime e Castigo – Fiodor Dostoievski
Curiosidade Mórbida: a ciência e a vida secreta dos cadáveres – Mary Roach
Cândido – Voltaire
Cão Raivoso – Stephen King
David Copperfield – Charles Dickens
David e Lisa – Dr Theodore Issac Rubin M.D
Deenie – Judy Blume
Divinos Segredos – Rebecca Wells
Dom Quixote de La Mancha – Miguel Cervantes
E o Vento Levou – Margaret Mitchell
Edgar Allan Poe: Complete Tales & Poems – Edgar Allan Poe
Eleanor Roosevelt – Blanche Wiesen Cook
Ella Minnow Pea: A Novel in Letters – Mark Dunn
Eloise – Kay Thompson
Emily, the Strange: Os Dias Perdidos – Roger Reger
Emma – Jane Austen
Empire Falls – Richard Russo
Encyclopedia Brown: Boy Detective – Donald J. Sobol
Enquanto Agonizo – William Faulkner
Entre Dois Amores – Isak Dinesen
Esperando Godot – Samuel Beckett
Ethan Frome – Edith Wharton
Eu Falar Bonito Um Dia – David Sedaris
Europe through the Back Door, 2003 – Rick Steves
Eva Luna – Isabel Allende
Extravagance – Gary Krist
Fahrenheit 451 – Ray Bradbury
Fahrenheit 9/11 – Michael Moore
Fala, Memória – Vladimir Nabokov
Fat Land: How Americans Became the Fattest People in the World – Greg Critser
Finnegan’s Wake – James Joyce
Fletch Venceu – Gregory McDonald
Flowers for Algernon – Daniel Keyes
Folhas de Relva – Walt Whitman
Frankenstein – Mary Shelley
Franny e Zooey – J. D. Salinger
Frenesi Polissilábico – Nick Hornby
Galápagos – Kurt Vonnegut
Garota, Interrompida – Susanna Kaysen
Gender Trouble – Judith Butler
George W. Bushism: The Slate Book of the Accidental Wit and Wisdom of our 43rd President – Jacob Weisberg
Gidget – Frederick Kohner
Grandes Esperanças – Charles Dickens
Guerra e Paz – Leon Tolstoi
Hamlet – William Shakespeare
Harry Potter e a Pedra Filosofal – J. K. Rowling
Harry Potter e o Cálice de Fogo – J. K. Rowling
Helter Skelter: The True Story of the Manson Murders – Vincent Bugliosi e Curt Gentry
Henry IV, parte I – William Shakespeare
Henry IV, parte II – William Shakespeare
Henry V – William Shakespeare
História da Minha Vida – Helen Keller
Holidays on Ice: Stories – David Sedaris
How the Light Gets In – M. J. Hyland
Inferno – Dante Alighieri
Ironweed – William J. Kennedy
It Takes a Village – Hillary Rodham Clinton
Jane Eyre – Charlotte Bronte
Just a Couple of Days – Tony Vigorito
Júlio César – William Shakespeare
Laranja Mecânica – Anthony Burgess
Laços Humanos – Betty Smith
Laços de Ternura – Larry McMurtry
Lendas da Vida – Steven Pressfield
Lendo Lolita em Teerã: Memórias de uma resistência literária – Azar Nafisi
Lies and the Lying Liars Who Tell Them – Al Franken
Love Story: Uma História de Amor – Erich Segal
Macbeth – William Shakespeare
Madame Bovary – Gustave Flaubert
Matadouro 5 – Kurt Vonnegut
Medo e Delírio em Las Vegas – Hunter S. Thompson
Memoirs of General W. T. Sherman – William Tecumseh Sherman
Memórias de uma Moça Bem Comportada – Simone de Beauvoir
Mencken’s Chrestomathy – H. R. Mencken
Menos que Zero* – Bret Easton Ellis
Meus Dias de Escritor – Tobias Wolff
Middlesex – Jeffrey Eugenides
Miséria à Americana: vivendo de subemprego nos Estados Unidos – Barbara Ehrenreich
Moby Dick – Herman Melvillelivros07
Moliere: A Biography – Hobart Chatfield Taylor
Mrs. Dalloway – Virginia Woolf
Mulherzinhas – Louisa May Alcott
Mutiny on the Bounty – Charles Nordhoff e James Norman Hall
My Lai 4: A Report on the Massacre and Its Aftermath – Seymour M. Hersh
My Life as Author and Editor – H. R. Mencken
My Life in Orange: Growing Up with the Guru – Tim Guest
Myra Waldo’s Travel and Motoring Guide to Europe, 1978 – Myra Waldo
Nervous System: Or, Losing My Mind in Literature – Jan Lars Jensen
New Poems of Emily Dickinson – Emily Dickinson
No Caminho de Swann – Marcel Proust
Novels 1930-1942: Dance Night/Come Back to Sorrento, Turn, Magic Wheel/Angels on Toast/A Time to be Born – Dawn Powelllivros08210. Notas de um Velho Safado –Charles Bukowski
O Amante de Lady Chatterley – D. H. Lawrence
O Ano do Pensamento Mágico – Joan Didion
O Apanhador no Campo de Centeio – J. D. Salinger
O Bebê de Rosemary – Ira Levin
O Bom Soldado – Ford Maddox Ford
O Caçador de Pipas – Khaled Hosseini
O Clube da Sorte da Alegria – Amy Tan
O Conde de Monte Cristo – Alexandre Dumas
O Coração das Trevas – Joseph Conrad
O Corcunda de Notre Dame – Victor Hugo
O Corvo – Edgar Allan Poe
O Código da Vinci – Dan Brown
O Deus das Pequenas Coisas – Arundhati Roy
O Diário de Anne Frank – Anne Frank
O Estranho Caso do Cão Morto – Mark Haddonlivros0254. Filha da Fortuna – Isabel Allende
O Fio da Navalha – W. Somerset Maugham
O Grande Gatsby – F. Scott Fitzgerald
O Grupo – Mary McCarthy
O Iluminado – Stephen King
O Livro do Disco. The Velvet Underground e Nico – Joe Harvard
O Mestre e Margarida – Mikhail Bulgakov
O Milagre de Anne Sullivan – William Gibson
O Morro dos Ventos Uivantes – Emily Bronte
O Mágico de Oz – Frank L. Baum
O Médico e o Monstro – Robert Louis Stevenson
O Nome da Rosa – Umberto Eco
O Poderoso Chefão: Livro 1 – Mario Puzo
O Processo – Franz Kafka
O Retorno do Rei – J. R. R. Tolkien
O Retrato de Dorian Gray – Oscar Wilde
O Segundo Sexo – Simone de Beauvoir
O Senhor das Moscas – William Golding
O Sol Também se Levanta – Ernest Hemingway
O Sol é para Todos – Harper Lee
O Som e a Fúria – William Faulkner
O Teste do Ácido do Refresco Elétrico – Tom Wolfe
O Vale das Bonecas – Jacqueline Susann
O Vento Será tua Herança – Jerome Lawrence e Robert E. Lee
O Xará – Jhumpa Lahiri
O que terá acontecido a Baby Jane? – Henry Farrell
On the Road: Pé na Estrada – Jack Kerouac
Orgulho e Preconceito – Jane Austen
Oryx e Crake – Margaret Atwood
Os Brutos Também Amam – Jack Shaefer
Os Cantos de Cantuária – Chaucer
Os Demônios – Fiodor Dostoievski
Os Diários de Sylvia Plath (1950-1962) – Sylvia Plath
Os Evangelhos Gnósticos – Elaine Pagels
Os Irmãos Bielski – Peter Duffy
Os Nus e os Mortos – Norman Mailer
Os Sonetos – William Shakespeare
Os Últimos Dias dos Romanov – Robert Alexander
Otelo – Shakespeare
Our Mutual Friend – Charles Dickens
Paris é uma Festa – Ernest Hemingway
Pequena Ilha – Andrea Levy
Pigmaleão – George Bernard Shaw
Pigs at the Trough – Arianna Huffington
Pinóquio – Carlo Collodi
Please Kill Me: The Uncensored Oral History of Punk – Legs McNeil e Gillian McCain
Property – Valerie Martinlivros09
Pushkin: A Biography – T. J. Binyon
Pétala Escarlate, Flor Branca – Michel Faber
Quattrocento – James Mckean
Quem Mexeu no meu Queijo? – Spencer Johnson
Quem tem Medo de Virginia Woolf – Edward Albee
R Is for Ricochet – Sue Grafton
Rapunzel – Os Irmãos Grimm
Razão e Sensibilidade – Jane Austen
Rebecca of Sunnybrook Farm – Kate Douglas Wiggin
Rebecca – Daphne du Maurier
Reparação – Ian McEwan
Rescuing Patty Hearst: Memories From a Decade Gone Mad – Virginia Holman
Richard III – William Shakespeare
Rita Hayworth (conto publicado no Brasil no livro Quatro Estações) – Stephen King
Robert’s Rules of Order – Henry Robert
Roman Holiday – Edith Wharton
Romeu e Julieta – William Shakespeare
S Is for Silence – Sue Grafton
Sacred Time – Ursula Hegi
Santuário – William Faulkner
Savage Beauty: The Life of Edna St. Vincent Millay – Nancy Milford
Say Goodbye to Daisy Miller – Henry James
Seabiscuit: Alma de Herói – Laura Hillenbrand
Secrets of the Flesh: A Life of Colette – Judith Thurman
Selected Hotels of Europe
Selected Letters of Dawn Powell: 1913-1965 – Dawn Powell
Senhor Proust – Celeste Albaret
Several Biographies of Winston Churchill
Sexta-Feira Muito Louca – Mary Rodgers
Sexus – Henry Miller
Sidarta – Hermann Hesse
Sobre Ratos e Homens – John Steinbeck
Social Origins of Dictatorship and Democracy: Lord and Peasant in the Making of the Modern World – Barrington Moore
Sonetos Portugueses – Elizabeth Barrett Browninglivros11
Song of the Simple Truth: The Complete Poems of Julia de Burgos – Julia de Burgos
Stuart Little – E. B. White
Suave é a Noite – F. Scott Fitzgerald
Swimming with Giants: My Encounters with Whales, Dolphins and Seals – Anne Collett
Sybil – Flora Rheta Schreiber
The Archidamian War – Donald Kagan
The Awakening – Kate Chopin
The Children’s Hour – Lillian Hellman
The Code of the Woosters – P.G. Wodehouse
The Collected Stories – Eudora Welty
The Complete Poems – Anne Sexton
The Devil in the White City: Murder, Magic, and Madness at the Fair that Changed America – Erik Larson
The Dirt: Confessions of the World’s Most Notorious Rock Band – Tommy Lee, Vince Neil, Mick Mars e Nikki Sixx
The Fall of the Athenian Empire – Donald Kagan
The Fortress of Solitude – Jonathan Lethem
The Gospel According to Judy Bloom – Judy Bloom
The Holy Barbarians – Lawrence Lipton
The Last Empire: Essays 1992-2000 – Gore Vidal
The Little Locksmith – Katharine Butler Hathaway
The Lottery: And Other Stories – Shirley Jackson
The Manticore – Robertson Davies
The Meaning of Consuelo – Judith Ortiz Cofer
The Mojo Collection: The Ultimate Music Companion – Jim Irvin
The Nanny Diaries – Emma McLaughlin
The New Way Things Work – David Macaulay
The Norton Anthology of Theory and Criticism – William E. Cain, Laurie A. Finke, Barbara E. Johnson, John P. McGowan
The Opposite of Fate: Memories of a Writing Life – Amy Tan
The Outbreak of the Peloponnesian War – Donald Kagan
The Peace of Nicias and the Sicilian Expedition – Donald Kagan
The Portable Dorothy Parker – Dorothy Parker
The Portable Nietzche – Fredrich Nietzche
The Price of Loyalty: George W. Bush – the White House, and the Education of Paul O’Neill – Ron Suskind
The Red Tent – Anita Diamant
The Rough Guide to Europe – 2003 Edition
The Scarecrow of Oz – Frank L. Baumlivros10
The Song Reader – Lisa Tucker
The Song of Names – Norman Lebrecht
The True and Outstanding Adventures of the Hunt Sisters – Elisabeth Robinson
The Vanishing Newspaper – Philip Meyers
Time and Again – Jack Finney
Truth & Beauty: A Friendship – Ann Patchett
Tudo se Ilumina – Jonathan Safran Foer
Uivo – Allen Ginsberg
Ulysses – James Joyce
Um Bonde Chamado Desejo – Tennessee Williams
Um Conto de Duas Cidades – Charles Dickens
Um Conto de Natal – Charles Dickens
Um Estranho no Ninho – Ken Kesey
Um Lugar Chamado Brick Lane – Monica Ali
Um Olhar do Paraíso – Alice Sebold
Um Teto Todo Seu – Virginia Woolf
Um Violinista no Telhado – Joseph Stein
Uma Aventura na Martinica – Ernest Hemingway
Uma Confraria de Tolos – John Kennedy Toole
Uma Ilha de Paz – John Knowles
Uma Janela para o Amor – E. M. Forster
Uma Passagem para a Índia – E. M. Forster
Uma Prova de Amor – Jodi Picoult
Uma Tragédia Americana – Theodore Dreiser
Vidas Sem Rumo – S. E. Hinton
Virtude Selvagem – Marjorie Kinnan Rawlings
Vivendo a História – Hillary Rodham Clinton
Walden ou A Vida nos Bosques – Henry David Thoreau
We Owe You Nothing, Punk Planet: The Collected Interviews – editado por Daniel Sinker
What Colour is Your Parachute? 2005 – Richard Nelson Bolles
When the Emperor Was Divine – Julie Otsuka
Wicked: A história não contada das Bruxas de Oz – Gregory Maguire
Ética – Spinoza